14
Living_Plaza -6.97631 107.63645
Telkom_University -6.97282 107.63613
Transmart_BuahBatu -6.96644 107.63801
Margacinta_Park -6.95506 107.64793
Masjid_Agung_BuahBatu -6.95425 107.63977
RS_Mayapada -6.94901 107.63438
ISBI -6.94296 107.62843
Borma_Kiaracondong -6.94296 107.642
Simpang_Bojongsoang_Podomoro -6.97561 107.6354
Simpang_BuahBatu_Ciparay -6.95872 107.6394
Simpang_TerusanBuahBatu_IbrahimAdjie -6.95445 107.63906
Simpang_IbrahimAdjie_Margacinta -6.95411 107.6402
Simpang_IbrahimAdjie_Soetta -6.94544 107.64185
Simpang_BuahBatu_Soetta -6.94806 107.63349
000 000 000 000 000 000 000 000 138 000 000 000 000 000
000 000 740 000 000 000 000 000 320 000 000 000 000 000
000 740 000 000 000 000 000 000 000 874 000 000 000 000
000 000 000 000 000 000 000 000 000 000 000 860 000 000
000 000 000 000 000 000 000 000 000 000 083 052 000 000
000 000 000 000 000 000 000 000 000 000 796 000 000 142
000 000 000 000 000 000 000 000 000 000 000 000 000 803
000 000 000 000 000 000 000 000 000 000 000 000 280 000
138 320 000 000 000 000 000 000 000 000 000 000 000 000
000 000 874 000 000 000 000 000 000 000 478 000 000 000
000 000 000 000 083 796 000 000 000 478 000 000 000 000
000 000 000 860 052 000 000 000 000 000 000 000 984 000
000 000 000 000 000 000 000 280 000 000 000 984 000 970
000 000 000 000 000 142 803 000 000 000 000 000 970 000